NO ./textures/david.xpm
SO ./textures/david.xpm
WE ./textures/david.xpm
EA ./textures/david.xpm

F 0,100,     0
C         0, 0         ,        70

 11111111111111111111111111111111111
1S                                  1
1                                   1
1  1111   111111  11  11 11 1111    1
1  1111   111111  11  11 11 1111    1
1  11  11 11  11  11  11 11 11  11  1
1  11  11 11  11  11  11 11 11  11  1
1  11  11 111111  11  11 11 11  11  1
1                                   1
1  11  11 11  11  11  11 11 11  11  1
1  11  11 11  11  11  11 11 11  11  1
1  1111   11  11    11   11 1111    1
1  1111   11  11    11   11 1111    1
1                                   1
1                                   1
 11111111111111111111111111111111111
