NO ./textures/eagle.xpm
SO ./textures/eagle.xpm
WE ./textures/greystone.xpm
EA ./textures/greystone.xpm

C 200,200,200
F 30,30,30

 11   111111111111111111111111111111111
1  1 1                                 1
1  1 1 W                               1
1  1 1   111111111111111111111111111   1
1  1 1  1                           1  1
1  1 1  1  11111111111111111111111  1  1
1  1 1  1 1                       1 1  1
1  1 1  1 1                       1 1  1
1  1 1  1 1   11111111111111111   1 1  1
1  1 1  1 1  1                 1  1 1  1
1  1 1  1 1  1  1111111111111  1  1 1  1
1  1 1  1 1  1 1             1 1  1 1  1
1  1 1  1 1  1 1             1 1  1 1  1
1  1 1  1 1  1 1   1111111   1 1  1 1  1
1  1 1  1 1  1 1  1       1  1 1  1 1  1
1  1 1  1 1  1 1  1  111  1  1 1  1 1  1
1  1 1  1 1  1 1  1 1   1 1  1 1  1 1  1
1  1 1  1 1  1 1  1 1   1 1  1 1  1 1  1
1  1 1  1 1  1 1  1 1   1 1  1 1  1 1  1
1  1 1  1 1  1 1  1  1  1 1  1 1  1 1  1
1  1 1  1 1  1 1  1  1  1 1  1 1  1 1  1
1  1 1  1 1  1 1   11   1 1  1 1  1 1  1
1  1 1  1 1  1 1        1 1  1 1  1 1  1
1  1 1  1 1  1 1        1 1  1 1  1 1  1
1  1 1  1 1  1  11111111  1  1 1  1 1  1
1  1 1  1 1  1            1  1 1  1 1  1
1  1 1  1 1   111111111111   1 1  1 1  1
1  1 1  1 1                  1 1  1 1  1
1  1 1  1 1                  1 1  1 1  1
1  1 1  1  111111111111111111  1  1 1  1
1  1 1  1                      1  1 1  1
1  1 1   1111111111111111111111   1 1  1
1  1 1                            1 1  1
1  1 1                            1 1  1
1  1  1111111111111111111111111111  1  1
1  1                                1  1
1   11111111111111111111111111111111   1
1                                      1
1                                      1
 11111111111111111111111111111111111111
