NO ./textures/north.xpm
SO ./textures/south.xpm
WE ./textures/west.xpm
EA ./textures/east.xpm

F  164, 169,205
C 153 ,204,  255

111111111111111
1000000000001111111111
100000011110         1
10000E0100101       101
1000000000001111111111
1000000000000000000001
1111111111111111111111
