NO ./textures/subject/bluestone.xpm
SO ./textures/subject/eagle.xpm
EA ./textures/subject/greystone.xpm
WE ./textures/subject/redbrick.xpm

F 0,0,0
C 0,0,0

11111
10N01
1W0E1
10S01
11111
