NO ./textures/subject/bluestone.xpm
SO ./textures/subject/eagle.xpm
EA ./textures/subject/greystone.xpm
WE ./textures/subject/redbrick.xpm

F 0,0,0
C 0,0,0

11111
1NN01
10001
10001
11111
