NO ./textures/redbrick.xpm
SO ./textures/redbrick.xpm
WE ./textures/bluestone.xpm
EA ./textures/bluestone.xpm

F 0,255,0
C 0,255,255

NO ./textures/42/redbrick.xpm

 11111111111111111
1E                1
1                 1
1  11  11 111111  1
1  11  11 111111  1
1  11  11     11  1
1  11  11     11  1
1  111111 111111  1
1                 1
1      11 11      1
1      11 11      1
1      11 111111  1
1      11 111111  1
1                 1
1                 1
 11111111111111111
